                                                                                          
                                            ____                                          
                                         __(    )__                            ___        
                                        (_        _)                         _(   )_      
            ____              ___         (______)                          (_______)     
          _(    )_          _(   )_                        ___                            
         (________)        (_______)                    __(   )__                         
                                                      _(         )_                       
                                                     (_____________)                      
                                                                                          
                                                                                          
                                                                                          
                                                                                          
                                                                                          
                 _                                    /\                                  
                ( )                                  /  \                                 
               (   )                              /\/    \                                
              (_   _)                            /        \                               
                | |                             /          \                              
TTTTTTTTTTTTTTTTTTTTTTTTTTTTTTTTTTTTTTTTTTTTTTTTTTTTTTTTTTTTTTTTTTTTTTTTTTTTTTTTTTTTTTTTTT
| | | | | | | | | | | | | | | | | | | | | | | | | | | | | | | | | | | | | | | | | | | | | 
 | | | | | | | | | | | | | | | | | | | | | | | | | | | | | | | | | | | | | | | | | | | | |
| | | | | | | | | | | | | | | | | | | | | | | | | | | | | | | | | | | | | | | | | | | | | 
 | | | | | | | | | | | | | | | | | | | | | | | | | | | | | | | | | | | | | | | | | | | | |
